--------------------------------------------------------------------------------
|..............................................................................|
|..............................................................................|
|..............................................................................|
|.............................................-----------......................|
|.............................................|.........|......................|
|.............................................|.........|......................|
|.............................................|.........|......................|
|.............................................|.........|......................|
|.............................................|--#------|......................|
|..............................................................................|
|..............................................................................|
|..............................................................................|
|..............................................................................|
|..............................................................................|
|..............................................................................|
|..............................................................................|
|..............................................................................|
|....#####.###..##.#####.......................................................|
|......#...##..#.....#.........................................................|
|......#...#....##...#.........................................................|
|......#...###.###...#.........................................................|
|..............................................................................|
--------------------------------------------------------------------------------
